ameya_basketball_lab	ameya_basketball_lab	1
ameya_basketball_outdoor1	ameya_basketball_outdoor1	1
ameya_basketball_outdoor2	ameya_basketball_outdoor2	1
ameya_bending_indoor2	ameya_bending_indoor2	1
ameya_bending_lab	ameya_bending_lab	1
ameya_bending_outdoor1	ameya_bending_outdoor1	1
ameya_bending_outdoor2	ameya_bending_outdoor2	1
ameya_bowlingright_indoor2	ameya_bowlingright_indoor2	1
ameya_bowlingright_lab	ameya_bowlingright_lab	1
ameya_bowlingright_outdoor1	ameya_bowlingright_outdoor1	1
ameya_bowlingright_outdoor2	ameya_bowlingright_outdoor2	1
ameya_boxing_indoor2	ameya_boxing_indoor2	1
ameya_boxing_lab	ameya_boxing_lab	1
ameya_boxing_outdoor1	ameya_boxing_outdoor1	1
ameya_boxing_outdoor2	ameya_boxing_outdoor2	1
ameya_clapping_indoor2	ameya_clapping_indoor2	1
ameya_clapping_lab	ameya_clapping_lab	1
ameya_clapping_outdoor1	ameya_clapping_outdoor1	1
ameya_clapping_outdoor2	ameya_clapping_outdoor2	1
ameya_closebox_lab	ameya_closebox_lab	1
ameya_closelaptop_lab	ameya_closelaptop_lab	1
ameya_crouching_lab	ameya_crouching_lab	1
ameya_crouching_outdoor1	ameya_crouching_outdoor1	1
ameya_crouching_outdoor2	ameya_crouching_outdoor2	1
ameya_crouching2_lab	ameya_crouching2_lab	1
ameya_exercise_indoor2	ameya_exercise_indoor2	1
ameya_exercise_lab	ameya_exercise_lab	1
ameya_exercise_outdoor1	ameya_exercise_outdoor1	1
ameya_exercise_outdoor2	ameya_exercise_outdoor2	1
ameya_hopping_indoor2	ameya_hopping_indoor2	1
ameya_hopping_lab	ameya_hopping_lab	1
ameya_hopping_outdoor1	ameya_hopping_outdoor1	1
ameya_hopping_outdoor2	ameya_hopping_outdoor2	1
ameya_hopping2_outdoor1	ameya_hopping2_outdoor1	1
ameya_hopping2_outdoor2	ameya_hopping2_outdoor2	1
ameya_jogging_indoor2	ameya_jogging_indoor2	1
ameya_jogging_lab	ameya_jogging_lab	1
ameya_jogging_outdoor1	ameya_jogging_outdoor1	1
ameya_jogging_outdoor2	ameya_jogging_outdoor2	1
ameya_jumping_indoor2	ameya_jumping_indoor2	1
ameya_jumping_lab	ameya_jumping_lab	1
ameya_jumping_outdoor1	ameya_jumping_outdoor1	1
ameya_jumping_outdoor2	ameya_jumping_outdoor2	1
ameya_kneelingleft_indoor2	ameya_kneelingleft_indoor2	1
ameya_kneelingleft_lab	ameya_kneelingleft_lab	1
ameya_kneelingleft_outdoor1	ameya_kneelingleft_outdoor1	1
ameya_kneelingleft_outdoor2	ameya_kneelingleft_outdoor2	1
ameya_kneelingright_indoor2	ameya_kneelingright_indoor2	1
ameya_kneelingright_lab	ameya_kneelingright_lab	1
ameya_kneelingright_outdoor1	ameya_kneelingright_outdoor1	1
ameya_kneelingright_outdoor2	ameya_kneelingright_outdoor2	1
ameya_lyingoncouch_lab	ameya_lyingoncouch_lab	1
ameya_movingobject_lab	ameya_movingobject_lab	1
ameya_movingobject_outdoor1	ameya_movingobject_outdoor1	1
ameya_movingobject_outdoor2	ameya_movingobject_outdoor2	1
ameya_openbox_lab	ameya_openbox_lab	1
ameya_openlaptop_lab	ameya_openlaptop_lab	1
ameya_pickobjectleft_indoor2	ameya_pickobjectleft_indoor2	1
ameya_pickobjectleft_lab	ameya_pickobjectleft_lab	1
ameya_pickobjectleft_outdoor1	ameya_pickobjectleft_outdoor1	1
ameya_pickobjectleft_outdoor2	ameya_pickobjectleft_outdoor2	1
ameya_pickobjectright_indoor2	ameya_pickobjectright_indoor2	1
ameya_pickobjectright_lab	ameya_pickobjectright_lab	1
ameya_pickobjectright_outdoor1	ameya_pickobjectright_outdoor1	1
ameya_pickobjectright_outdoor2	ameya_pickobjectright_outdoor2	1
ameya_pickupbowl_lab	ameya_pickupbowl_lab	1
ameya_pushup_indoor2	ameya_pushup_indoor2	1
ameya_pushup_lab	ameya_pushup_lab	1
ameya_pushup_outdoor1	ameya_pushup_outdoor1	1
ameya_pushup_outdoor2	ameya_pushup_outdoor2	1
ameya_putdownbowl_lab	ameya_putdownbowl_lab	1
ameya_reading_lab	ameya_reading_lab	1
ameya_rollingchair_lab	ameya_rollingchair_lab	1
ameya_rotating_indoor2	ameya_rotating_indoor2	1
ameya_rotating_lab	ameya_rotating_lab	1
ameya_rotating_outdoor1	ameya_rotating_outdoor1	1
ameya_rotating_outdoor2	ameya_rotating_outdoor2	1
ameya_sitonchair_lab	ameya_sitonchair_lab	1
ameya_sitoncouch_lab	ameya_sitoncouch_lab	1
ameya_sitonground_indoor2	ameya_sitonground_indoor2	1
ameya_sitonground_lab	ameya_sitonground_lab	1
ameya_sitonground_outdoor1	ameya_sitonground_outdoor1	1
ameya_sitonground_outdoor2	ameya_sitonground_outdoor2	1
ameya_soccerleft_indoor2	ameya_soccerleft_indoor2	1
ameya_soccerleft_lab	ameya_soccerleft_lab	1
ameya_soccerleft_outdoor1	ameya_soccerleft_outdoor1	1
ameya_soccerleft_outdoor2	ameya_soccerleft_outdoor2	1
ameya_soccerright_indoor2	ameya_soccerright_indoor2	1
ameya_soccerright_lab	ameya_soccerright_lab	1
ameya_soccerright_outdoor1	ameya_soccerright_outdoor1	1
ameya_soccerright_outdoor2	ameya_soccerright_outdoor2	1
ameya_standfromcouch_lab	ameya_standfromcouch_lab	1
ameya_standupfromchair_lab	ameya_standupfromchair_lab	1
ameya_standupfromground_indoor2	ameya_standupfromground_indoor2	1
ameya_standupfromground_lab	ameya_standupfromground_lab	1
ameya_standupfromground_outdoor1	ameya_standupfromground_outdoor1	1
ameya_standupfromground_outdoor2	ameya_standupfromground_outdoor2	1
ameya_tabletennis_indoor2	ameya_tabletennis_indoor2	1
ameya_tabletennis_lab	ameya_tabletennis_lab	1
ameya_tabletennis_outdoor1	ameya_tabletennis_outdoor1	1
ameya_tabletennis_outdoor2	ameya_tabletennis_outdoor2	1
ameya_throwingleft_indoor2	ameya_throwingleft_indoor2	1
ameya_throwingleft_lab	ameya_throwingleft_lab	1
ameya_throwingleft_outdoor1	ameya_throwingleft_outdoor1	1
ameya_throwingleft_outdoor2	ameya_throwingleft_outdoor2	1
ameya_throwingright_indoor2	ameya_throwingright_indoor2	1
ameya_throwingright_lab	ameya_throwingright_lab	1
ameya_throwingright_outdoor1	ameya_throwingright_outdoor1	1
ameya_throwingright_outdoor2	ameya_throwingright_outdoor2	1
ameya_turning_indoor2	ameya_turning_indoor2	1
ameya_turning_lab	ameya_turning_lab	1
ameya_turning_outdoor1	ameya_turning_outdoor1	1
ameya_turning_outdoor2	ameya_turning_outdoor2	1
ameya_typing_lab	ameya_typing_lab	1
ameya_walking_indoor2	ameya_walking_indoor2	1
ameya_walking_lab	ameya_walking_lab	1
ameya_walking_outdoor1	ameya_walking_outdoor1	1
ameya_walking_outdoor2	ameya_walking_outdoor2	1
ameya_walking2_indoor2	ameya_walking2_indoor2	1
ameya_walking2_outdoor1	ameya_walking2_outdoor1	1
ameya_walking3_indoor2	ameya_walking3_indoor2	1
ameya_waving_indoor2	ameya_waving_indoor2	1
ameya_waving_lab	ameya_waving_lab	1
ameya_waving_outdoor1	ameya_waving_outdoor1	1
ameya_waving_outdoor2	ameya_waving_outdoor2	1
bin_basketball_indoor2	bin_basketball_indoor2	1
bin_basketball_lab	bin_basketball_lab	1
bin_basketball_outdoor3	bin_basketball_outdoor3	1
bin_basketball2_lab	bin_basketball2_lab	1
bin_basketball2_outdoor3	bin_basketball2_outdoor3	1
bin_bending_lab	bin_bending_lab	1
bin_bending_outdoor3	bin_bending_outdoor3	1
bin_bowlingleft_indoor2	bin_bowlingleft_indoor2	1
bin_bowlingleft_outdoor3	bin_bowlingleft_outdoor3	1
bin_bowlingleft2_outdoor3	bin_bowlingleft2_outdoor3	1
bin_bowlingright_indoor2	bin_bowlingright_indoor2	1
bin_bowlingright_lab	bin_bowlingright_lab	1
bin_bowlingright_outdoor3	bin_bowlingright_outdoor3	1
bin_boxing_indoor2	bin_boxing_indoor2	1
bin_boxing_lab	bin_boxing_lab	1
bin_boxing_outdoor3	bin_boxing_outdoor3	1
bin_clapping_indoor2	bin_clapping_indoor2	1
bin_clapping_lab	bin_clapping_lab	1
bin_clapping_outdoor3	bin_clapping_outdoor3	1
bin_closebox_lab	bin_closebox_lab	1
bin_closefridge_lab	bin_closefridge_lab	1
bin_crouching_indoor2	bin_crouching_indoor2	1
bin_crouching_lab	bin_crouching_lab	1
bin_crouching_outdoor3	bin_crouching_outdoor3	1
bin_exercise_indoor2	bin_exercise_indoor2	1
bin_exercise_lab	bin_exercise_lab	1
bin_exercise_outdoor3	bin_exercise_outdoor3	1
bin_hopping_indoor2	bin_hopping_indoor2	1
bin_hopping_lab	bin_hopping_lab	1
bin_hopping_outdoor3	bin_hopping_outdoor3	1
bin_jogging_indoor2	bin_jogging_indoor2	1
bin_jogging_lab	bin_jogging_lab	1
bin_jogging_outdoor3	bin_jogging_outdoor3	1
bin_jumping_indoor2	bin_jumping_indoor2	1
bin_jumping_lab	bin_jumping_lab	1
bin_jumping_outdoor3	bin_jumping_outdoor3	1
bin_kickingleft_indoor2	bin_kickingleft_indoor2	1
bin_kickingleft_outdoor3	bin_kickingleft_outdoor3	1
bin_kickingleft2_outdoor3	bin_kickingleft2_outdoor3	1
bin_kickingright_indoor2	bin_kickingright_indoor2	1
bin_kickingright_outdoor3	bin_kickingright_outdoor3	1
bin_kickingright2_outdoor3	bin_kickingright2_outdoor3	1
bin_kneelingleft_indoor2	bin_kneelingleft_indoor2	1
bin_kneelingleft_lab	bin_kneelingleft_lab	1
bin_kneelingleft_outdoor3	bin_kneelingleft_outdoor3	1
bin_kneelingright_indoor2	bin_kneelingright_indoor2	1
bin_kneelingright_lab	bin_kneelingright_lab	1
bin_kneelingright_outdoor3	bin_kneelingright_outdoor3	1
bin_lyingoncouch_lab	bin_lyingoncouch_lab	1
bin_movingobject_indoor2	bin_movingobject_indoor2	1
bin_movingobject_outdoor3	bin_movingobject_outdoor3	1
bin_openbox_lab	bin_openbox_lab	1
bin_openfridge_lab	bin_openfridge_lab	1
bin_openlaptop_lab	bin_openlaptop_lab	1
bin_pickobjectleft_indoor2	bin_pickobjectleft_indoor2	1
bin_pickobjectleft_lab	bin_pickobjectleft_lab	1
bin_pickobjectleft_outdoor3	bin_pickobjectleft_outdoor3	1
bin_pickobjectright_indoor2	bin_pickobjectright_indoor2	1
bin_pickobjectright_lab	bin_pickobjectright_lab	1
bin_pickobjectright_outdoor3	bin_pickobjectright_outdoor3	1
bin_pickupbowl_lab	bin_pickupbowl_lab	1
bin_pushup_indoor2	bin_pushup_indoor2	1
bin_pushup_lab	bin_pushup_lab	1
bin_pushup_outdoor3	bin_pushup_outdoor3	1
bin_putdownbowl_lab	bin_putdownbowl_lab	1
bin_reading_lab	bin_reading_lab	1
bin_rollingchair_lab	bin_rollingchair_lab	1
bin_rotating_indoor2	bin_rotating_indoor2	1
bin_rotating_lab	bin_rotating_lab	1
bin_rotating_outdoor3	bin_rotating_outdoor3	1
bin_sitonchair_indoor2	bin_sitonchair_indoor2	1
bin_sitonchair_lab	bin_sitonchair_lab	1
bin_sitoncouch_lab	bin_sitoncouch_lab	1
bin_sitonground_indoor2	bin_sitonground_indoor2	1
bin_sitonground_lab	bin_sitonground_lab	1
bin_sitonground_outdoor3	bin_sitonground_outdoor3	1
bin_soccerleft_indoor2	bin_soccerleft_indoor2	1
bin_soccerleft_lab	bin_soccerleft_lab	1
bin_soccerleft_outdoor3	bin_soccerleft_outdoor3	1
bin_soccerright_indoor2	bin_soccerright_indoor2	1
bin_soccerright_lab	bin_soccerright_lab	1
bin_soccerright_outdoor3	bin_soccerright_outdoor3	1
bin_standfromcouch_lab	bin_standfromcouch_lab	1
bin_standupfromchair_indoor2	bin_standupfromchair_indoor2	1
bin_standupfromchair_lab	bin_standupfromchair_lab	1
bin_standupfromground_indoor2	bin_standupfromground_indoor2	1
bin_standupfromground_lab	bin_standupfromground_lab	1
bin_standupfromground_outdoor3	bin_standupfromground_outdoor3	1
bin_tabletennis_indoor2	bin_tabletennis_indoor2	1
bin_tabletennis_lab	bin_tabletennis_lab	1
bin_tabletennis_outdoor3	bin_tabletennis_outdoor3	1
bin_throwingleft_indoor2	bin_throwingleft_indoor2	1
bin_throwingleft_lab	bin_throwingleft_lab	1
bin_throwingleft_outdoor3	bin_throwingleft_outdoor3	1
bin_throwingright_indoor2	bin_throwingright_indoor2	1
bin_throwingright_lab	bin_throwingright_lab	1
bin_throwingright_outdoor3	bin_throwingright_outdoor3	1
bin_turning_indoor2	bin_turning_indoor2	1
bin_turning_lab	bin_turning_lab	1
bin_turning_outdoor3	bin_turning_outdoor3	1
bin_typing_lab	bin_typing_lab	1
bin_walking_indoor2	bin_walking_indoor2	1
bin_walking_lab	bin_walking_lab	1
bin_walking_outdoor3	bin_walking_outdoor3	1
bin_waving_indoor2	bin_waving_indoor2	1
bin_waving_lab	bin_waving_lab	1
bin_waving_outdoor3	bin_waving_outdoor3	1
enric_basketball_indoor2	enric_basketball_indoor2	1
enric_basketball_lab	enric_basketball_lab	1
enric_basketball_park1	enric_basketball_park1	1
enric_basketball_park2	enric_basketball_park2	1
enric_bending_indoor2	enric_bending_indoor2	1
enric_bending_lab	enric_bending_lab	1
enric_bending_park1	enric_bending_park1	1
enric_bending_park2	enric_bending_park2	1
enric_bowlingleft_indoor2	enric_bowlingleft_indoor2	1
enric_bowlingleft_lab	enric_bowlingleft_lab	1
enric_bowlingleft_park1	enric_bowlingleft_park1	1
enric_bowlingleft_park2	enric_bowlingleft_park2	1
enric_bowlingright_indoor2	enric_bowlingright_indoor2	1
enric_bowlingright_lab	enric_bowlingright_lab	1
enric_bowlingright_park1	enric_bowlingright_park1	1
enric_bowlingright_park2	enric_bowlingright_park2	1
enric_bowlingright2_lab	enric_bowlingright2_lab	1
enric_boxing_indoor2	enric_boxing_indoor2	1
enric_boxing_lab	enric_boxing_lab	1
enric_boxing_park1	enric_boxing_park1	1
enric_boxing_park2	enric_boxing_park2	1
enric_clapping_indoor2	enric_clapping_indoor2	1
enric_clapping_lab	enric_clapping_lab	1
enric_clapping_park1	enric_clapping_park1	1
enric_clapping_park2	enric_clapping_park2	1
enric_closebox_indoor2	enric_closebox_indoor2	1
enric_closebox_lab	enric_closebox_lab	1
enric_Closelaptop_lab	enric_Closelaptop_lab	1
enric_crouching_indoor2	enric_crouching_indoor2	1
enric_crouching_lab	enric_crouching_lab	1
enric_crouching_park1	enric_crouching_park1	1
enric_crouching_park2	enric_crouching_park2	1
enric_exercise_indoor2	enric_exercise_indoor2	1
enric_exercise_lab	enric_exercise_lab	1
enric_exercise_park1	enric_exercise_park1	1
enric_exercise_park2	enric_exercise_park2	1
enric_jogging_indoor2	enric_jogging_indoor2	1
enric_jogging_lab	enric_jogging_lab	1
enric_jogging_park1	enric_jogging_park1	1
enric_jogging_park2	enric_jogging_park2	1
enric_jumping_indoor2	enric_jumping_indoor2	1
enric_jumping_lab	enric_jumping_lab	1
enric_jumping_park1	enric_jumping_park1	1
enric_jumping_park2	enric_jumping_park2	1
enric_kickingleft_indoor2	enric_kickingleft_indoor2	1
enric_kickingleft_lab	enric_kickingleft_lab	1
enric_kickingleft_park1	enric_kickingleft_park1	1
enric_kickingleft_park2	enric_kickingleft_park2	1
enric_kickingright_indoor2	enric_kickingright_indoor2	1
enric_kickingright_lab	enric_kickingright_lab	1
enric_kickingright_park1	enric_kickingright_park1	1
enric_kickingright_park2	enric_kickingright_park2	1
enric_kneelingleft_indoor2	enric_kneelingleft_indoor2	1
enric_kneelingleft_lab	enric_kneelingleft_lab	1
enric_kneelingleft_park1	enric_kneelingleft_park1	1
enric_kneelingleft_park2	enric_kneelingleft_park2	1
enric_kneelingright_indoor2	enric_kneelingright_indoor2	1
enric_kneelingright_lab	enric_kneelingright_lab	1
enric_kneelingright_park1	enric_kneelingright_park1	1
enric_kneelingright_park2	enric_kneelingright_park2	1
enric_movingobject_indoor2	enric_movingobject_indoor2	1
enric_movingobject_lab	enric_movingobject_lab	1
enric_movingobject_park1	enric_movingobject_park1	1
enric_movingobject_park2	enric_movingobject_park2	1
enric_openbox_indoor2	enric_openbox_indoor2	1
enric_openbox_lab	enric_openbox_lab	1
enric_openbox2_lab	enric_openbox2_lab	1
enric_openlaptop_lab	enric_openlaptop_lab	1
enric_pickobjectleft_indoor2	enric_pickobjectleft_indoor2	1
enric_pickobjectleft_lab	enric_pickobjectleft_lab	1
enric_pickobjectleft_park1	enric_pickobjectleft_park1	1
enric_pickobjectleft_park2	enric_pickobjectleft_park2	1
enric_pickobjectright_indoor2	enric_pickobjectright_indoor2	1
enric_pickobjectright_lab	enric_pickobjectright_lab	1
enric_pickobjectright_park1	enric_pickobjectright_park1	1
enric_pickobjectright_park2	enric_pickobjectright_park2	1
enric_pickupbowl_indoor2	enric_pickupbowl_indoor2	1
enric_pickupbowl_lab	enric_pickupbowl_lab	1
enric_pushup_indoor2	enric_pushup_indoor2	1
enric_pushup_lab	enric_pushup_lab	1
enric_pushup_park1	enric_pushup_park1	1
enric_pushup_park2	enric_pushup_park2	1
enric_putdownbowl_indoor2	enric_putdownbowl_indoor2	1
enric_putdownbowl_lab	enric_putdownbowl_lab	1
enric_reading_indoor2	enric_reading_indoor2	1
enric_reading_lab	enric_reading_lab	1
enric_rollingchair_lab	enric_rollingchair_lab	1
enric_rotating_indoor2	enric_rotating_indoor2	1
enric_rotating_lab	enric_rotating_lab	1
enric_rotating_park1	enric_rotating_park1	1
enric_rotating_park2	enric_rotating_park2	1
enric_rotating2_park1	enric_rotating2_park1	1
enric_sitonchair_indoor2	enric_sitonchair_indoor2	1
enric_sitonchair_lab	enric_sitonchair_lab	1
enric_sitonground_indoor2	enric_sitonground_indoor2	1
enric_sitonground_lab	enric_sitonground_lab	1
enric_sitonground_park1	enric_sitonground_park1	1
enric_sitonground_park2	enric_sitonground_park2	1
enric_sitonground2_lab	enric_sitonground2_lab	1
enric_soccerleft_indoor2	enric_soccerleft_indoor2	1
enric_soccerleft_lab	enric_soccerleft_lab	1
enric_soccerright_indoor2	enric_soccerright_indoor2	1
enric_soccerright_lab	enric_soccerright_lab	1
enric_standupfromchair_indoor2	enric_standupfromchair_indoor2	1
enric_standupfromchair_lab	enric_standupfromchair_lab	1
enric_standupfromground_indoor2	enric_standupfromground_indoor2	1
enric_standupfromground_lab	enric_standupfromground_lab	1
enric_standupfromground_park1	enric_standupfromground_park1	1
enric_standupfromground_park2	enric_standupfromground_park2	1
enric_Standupfromground2_lab	enric_Standupfromground2_lab	1
enric_tabletennis_indoor2	enric_tabletennis_indoor2	1
enric_tabletennis_lab	enric_tabletennis_lab	1
enric_tabletennis_park1	enric_tabletennis_park1	1
enric_tabletennis_park2	enric_tabletennis_park2	1
enric_throwingleft_indoor2	enric_throwingleft_indoor2	1
enric_throwingleft_lab	enric_throwingleft_lab	1
enric_throwingleft_park1	enric_throwingleft_park1	1
enric_throwingleft_park2	enric_throwingleft_park2	1
enric_throwingright_indoor2	enric_throwingright_indoor2	1
enric_throwingright_lab	enric_throwingright_lab	1
enric_throwingright_park1	enric_throwingright_park1	1
enric_throwingright_park2	enric_throwingright_park2	1
enric_turning_indoor2	enric_turning_indoor2	1
enric_turning_lab	enric_turning_lab	1
enric_turning_park1	enric_turning_park1	1
enric_turning_park2	enric_turning_park2	1
enric_Typing_lab	enric_Typing_lab	1
enric_walking_indoor2	enric_walking_indoor2	1
enric_walking_lab	enric_walking_lab	1
enric_walking_park1	enric_walking_park1	1
enric_walking_park2	enric_walking_park2	1
enric_waving_indoor2	enric_waving_indoor2	1
enric_waving_lab	enric_waving_lab	1
enric_waving_park1	enric_waving_park1	1
enric_waving_park2	enric_waving_park2	1
enric_waving2_indoor2	enric_waving2_indoor2	1
jianxiong_basketball_outdoor4	jianxiong_basketball_outdoor4	1
jianxiong_basketball_park1	jianxiong_basketball_park1	1
jianxiong_basketball_park2	jianxiong_basketball_park2	1
jianxiong_bending_lab	jianxiong_bending_lab	1
jianxiong_bending_outdoor3	jianxiong_bending_outdoor3	1
jianxiong_bending_park1	jianxiong_bending_park1	1
jianxiong_bending_park2	jianxiong_bending_park2	1
jianxiong_bowlingleft_park2	jianxiong_bowlingleft_park2	1
jianxiong_bowlingright_lab	jianxiong_bowlingright_lab	1
jianxiong_bowlingright_outdoor4	jianxiong_bowlingright_outdoor4	1
jianxiong_bowlingright_park1	jianxiong_bowlingright_park1	1
jianxiong_bowlingright_park2	jianxiong_bowlingright_park2	1
jianxiong_boxing_lab	jianxiong_boxing_lab	1
jianxiong_boxing_outdoor3	jianxiong_boxing_outdoor3	1
jianxiong_boxing_outdoor4	jianxiong_boxing_outdoor4	1
jianxiong_boxing_park1	jianxiong_boxing_park1	1
jianxiong_Boxing_park2	jianxiong_Boxing_park2	1
jianxiong_clapping_lab	jianxiong_clapping_lab	1
jianxiong_clapping_outdoor3	jianxiong_clapping_outdoor3	1
jianxiong_clapping_outdoor4	jianxiong_clapping_outdoor4	1
jianxiong_clapping_park1	jianxiong_clapping_park1	1
jianxiong_clapping_park2	jianxiong_clapping_park2	1
jianxiong_closebox_lab	jianxiong_closebox_lab	1
jianxiong_closelaptop_lab	jianxiong_closelaptop_lab	1
jianxiong_crouching_lab	jianxiong_crouching_lab	1
jianxiong_crouching_outdoor3	jianxiong_crouching_outdoor3	1
jianxiong_crouching_outdoor4	jianxiong_crouching_outdoor4	1
jianxiong_crouching_park1	jianxiong_crouching_park1	1
jianxiong_crouching_park2	jianxiong_crouching_park2	1
jianxiong_exercise_lab	jianxiong_exercise_lab	1
jianxiong_exercise_outdoor3	jianxiong_exercise_outdoor3	1
jianxiong_exercise_outdoor4	jianxiong_exercise_outdoor4	1
jianxiong_exercise_park1	jianxiong_exercise_park1	1
jianxiong_exercise_park2	jianxiong_exercise_park2	1
jianxiong_hopping_lab	jianxiong_hopping_lab	1
jianxiong_hopping_outdoor3	jianxiong_hopping_outdoor3	1
jianxiong_hopping_outdoor4	jianxiong_hopping_outdoor4	1
jianxiong_hopping_park1	jianxiong_hopping_park1	1
jianxiong_hopping_park2	jianxiong_hopping_park2	1
jianxiong_jogging_lab	jianxiong_jogging_lab	1
jianxiong_jogging_outdoor4	jianxiong_jogging_outdoor4	1
jianxiong_jogging_park1	jianxiong_jogging_park1	1
jianxiong_jogging_park2	jianxiong_jogging_park2	1
jianxiong_jumping_lab	jianxiong_jumping_lab	1
jianxiong_jumping_outdoor3	jianxiong_jumping_outdoor3	1
jianxiong_jumping_outdoor4	jianxiong_jumping_outdoor4	1
jianxiong_jumping_park1	jianxiong_jumping_park1	1
jianxiong_jumping_park2	jianxiong_jumping_park2	1
jianxiong_kickingleft_park1	jianxiong_kickingleft_park1	1
jianxiong_kickingleft_park2	jianxiong_kickingleft_park2	1
jianxiong_kickingright_park1	jianxiong_kickingright_park1	1
jianxiong_kickingright_park2	jianxiong_kickingright_park2	1
jianxiong_kneelingleft_lab	jianxiong_kneelingleft_lab	1
jianxiong_kneelingleft_outdoor4	jianxiong_kneelingleft_outdoor4	1
jianxiong_kneelingleft_park1	jianxiong_kneelingleft_park1	1
jianxiong_kneelingleft_park2	jianxiong_kneelingleft_park2	1
jianxiong_kneelingright_lab	jianxiong_kneelingright_lab	1
jianxiong_kneelingright_outdoor4	jianxiong_kneelingright_outdoor4	1
jianxiong_Kneelingright_park1	jianxiong_Kneelingright_park1	1
jianxiong_Kneelingright_park2	jianxiong_Kneelingright_park2	1
jianxiong_lyingoncouch_lab	jianxiong_lyingoncouch_lab	1
jianxiong_movingobject_lab	jianxiong_movingobject_lab	1
jianxiong_movingobject_outdoor4	jianxiong_movingobject_outdoor4	1
jianxiong_movingobject_park1	jianxiong_movingobject_park1	1
jianxiong_movingobject_park2	jianxiong_movingobject_park2	1
jianxiong_openbox_lab	jianxiong_openbox_lab	1
jianxiong_openlaptop_lab	jianxiong_openlaptop_lab	1
jianxiong_pickobjectleft_lab	jianxiong_pickobjectleft_lab	1
jianxiong_pickobjectleft_outdoor3	jianxiong_pickobjectleft_outdoor3	1
jianxiong_pickobjectleft_outdoor4	jianxiong_pickobjectleft_outdoor4	1
jianxiong_pickobjectleft_park1	jianxiong_pickobjectleft_park1	1
jianxiong_pickobjectleft_park2	jianxiong_pickobjectleft_park2	1
jianxiong_pickobjectright_lab	jianxiong_pickobjectright_lab	1
jianxiong_pickobjectright_outdoor3	jianxiong_pickobjectright_outdoor3	1
jianxiong_pickobjectright_outdoor4	jianxiong_pickobjectright_outdoor4	1
jianxiong_pickobjectright_park1	jianxiong_pickobjectright_park1	1
jianxiong_pickobjectright_park2	jianxiong_pickobjectright_park2	1
jianxiong_pickupbowl_lab	jianxiong_pickupbowl_lab	1
jianxiong_pushup_lab	jianxiong_pushup_lab	1
jianxiong_pushup_outdoor4	jianxiong_pushup_outdoor4	1
jianxiong_pushup_park1	jianxiong_pushup_park1	1
jianxiong_pushup_park2	jianxiong_pushup_park2	1
jianxiong_putdownbowl_lab	jianxiong_putdownbowl_lab	1
jianxiong_reading_lab	jianxiong_reading_lab	1
jianxiong_rollingchair_lab	jianxiong_rollingchair_lab	1
jianxiong_rotating_lab	jianxiong_rotating_lab	1
jianxiong_rotating_outdoor3	jianxiong_rotating_outdoor3	1
jianxiong_rotating_outdoor4	jianxiong_rotating_outdoor4	1
jianxiong_rotating_park1	jianxiong_rotating_park1	1
jianxiong_rotating_park2	jianxiong_rotating_park2	1
jianxiong_sitonchair_lab	jianxiong_sitonchair_lab	1
jianxiong_sitoncouch_lab	jianxiong_sitoncouch_lab	1
jianxiong_sitonground_lab	jianxiong_sitonground_lab	1
jianxiong_sitonground_outdoor3	jianxiong_sitonground_outdoor3	1
jianxiong_sitonground_outdoor4	jianxiong_sitonground_outdoor4	1
jianxiong_sitonground_park1	jianxiong_sitonground_park1	1
jianxiong_sitonground_park2	jianxiong_sitonground_park2	1
jianxiong_soccerleft_lab	jianxiong_soccerleft_lab	1
jianxiong_soccerleft_outdoor4	jianxiong_soccerleft_outdoor4	1
jianxiong_soccerright_lab	jianxiong_soccerright_lab	1
jianxiong_soccerright_outdoor4	jianxiong_soccerright_outdoor4	1
jianxiong_standfromcouch_lab	jianxiong_standfromcouch_lab	1
jianxiong_standupfromchair_lab	jianxiong_standupfromchair_lab	1
jianxiong_standupfromground_lab	jianxiong_standupfromground_lab	1
jianxiong_standupfromground_outdoor3	jianxiong_standupfromground_outdoor3	1
jianxiong_standupfromground_outdoor4	jianxiong_standupfromground_outdoor4	1
jianxiong_standupfromground_park1	jianxiong_standupfromground_park1	1
jianxiong_standupfromground_park2	jianxiong_standupfromground_park2	1
jianxiong_tabletennis_lab	jianxiong_tabletennis_lab	1
jianxiong_tabletennis_outdoor4	jianxiong_tabletennis_outdoor4	1
jianxiong_tabletennis_park1	jianxiong_tabletennis_park1	1
jianxiong_tabletennis_park2	jianxiong_tabletennis_park2	1
jianxiong_throwingleft_lab	jianxiong_throwingleft_lab	1
jianxiong_throwingleft_outdoor3	jianxiong_throwingleft_outdoor3	1
jianxiong_throwingleft_outdoor4	jianxiong_throwingleft_outdoor4	1
jianxiong_throwingleft_park1	jianxiong_throwingleft_park1	1
jianxiong_throwingleft_park2	jianxiong_throwingleft_park2	1
jianxiong_throwingright_lab	jianxiong_throwingright_lab	1
jianxiong_throwingright_outdoor3	jianxiong_throwingright_outdoor3	1
jianxiong_throwingright_outdoor4	jianxiong_throwingright_outdoor4	1
jianxiong_throwingright_park1	jianxiong_throwingright_park1	1
jianxiong_throwingright_park2	jianxiong_throwingright_park2	1
jianxiong_turning_lab	jianxiong_turning_lab	1
jianxiong_turning_outdoor3	jianxiong_turning_outdoor3	1
jianxiong_turning_outdoor4	jianxiong_turning_outdoor4	1
jianxiong_turning_park1	jianxiong_turning_park1	1
jianxiong_turning_park2	jianxiong_turning_park2	1
jianxiong_typing_lab	jianxiong_typing_lab	1
jianxiong_walking_lab	jianxiong_walking_lab	1
jianxiong_walking_outdoor3	jianxiong_walking_outdoor3	1
jianxiong_walking_outdoor4	jianxiong_walking_outdoor4	1
jianxiong_walking_park2	jianxiong_walking_park2	1
jianxiong_waving_lab	jianxiong_waving_lab	1
jianxiong_waving_outdoor3	jianxiong_waving_outdoor3	1
jianxiong_waving_outdoor4	jianxiong_waving_outdoor4	1
jianxiong_waving_park1	jianxiong_waving_park1	1
jianxiong_waving_park2	jianxiong_waving_park2	1
